32 32
20 15
XXXXXXXXXXXXXXXXXXXX
X-------XX---------X
X-------XX---------X
X-------XX---------X
X------------------X
X------------------X
X-------XX---------X
X-------XX---------X
X-------XX---------X
XXXXXXXXXXX--XXXXXXX
XXXXXXXXXXX--XXXXXXX
X------------------X
X------------------X
X------------------X
XXXXXXXXXXXXXXXXXXXX