32 32
20 15
XXXXXXXXXXXXXXXXXXXX
X------------------X
X------------------X
XXXX------------XXXX
X--XXX--------XXX--X
X----XXX----XXX----X
X-----XXXXXXXX-----X
X------------------X
X------------------X
X------------------X
X------------------X
X------------------X
X------------------X
X------------------X
XXXXXXXXXXXXXXXXXXXX