32 32
20 15
XXXXXXXXXXXXXXXXXXXX
X------------------X
X------------------X
X------------------X
X------------------X
X------------------X
X------------------X
X------------------X
X------------------X
X------------------X
X------------------X
X------------------X
X------------------X
X------------------X
XXXXXXXXXXXXXXXXXXXX