32 32
20 15
XXXXXXXXXXXXXXXXXXXX
XXXXX---------XXXXXX
XXXXX---------XXXXXX
XXXXXXXXXXXXXXXXXXXX
XXXXX--XXXXX--XXXXXX
XXXXX--XXXXX--XXXXXX
XXXXXXXXXXXXXXXXXXXX
XXXXXXXXXXXXXXXXXXXX
XXXXX--XXXXX--XXXXXX
XXXXX--XXXXX--XXXXXX
XXXXXXXXXXXXXXXXXXXX
XXXXXXXXXXXXXXXXXXXX
XXXXX---------XXXXXX
XXXXX---------XXXXXX
XXXXXXXXXXXXXXXXXXXX